NO      "./wall.png"
SO      "./wall.png"
WE      "./wall.png"
EA      "./wall.png"

C 240,10,1
F       240,10,13

111   111
100001
111111