SO      "./wall.png"
WE      "./wall.png"
EA      "./wall.png"
C 240,10,1
F       240,10,13

NO      "./wall.png"

     111111111111111111111111                             
100000000000000000000001
              111111111111111111111111
