NO      "./wall.png"
SO      "./wall.png"
WE      "./wall.png"
EA      "./wall.png" 

C 240,10,255
F       240,10,13

11111111 1111
    100000001
1111111111111