NO  textures/wall_4.png
SO textures/wall_3.png
C                 5,11,5
F 125,30,0
WE textures/wall_2.png
EA textures/wall_1.png




        111111 111111111111111111
1111111110000111001100000000100011
        1011000001000100000000001111111
        10010000010000000000000000000111
1111111110110000000001000000000000000001
100000000011000000000000001111111011111111111111111111111111 11111111
11111111111111111D1111111111 1111D00000000000000001100001011D1
11110111111110000000N000000011111D1111111111111111111111111111111111111
11000011001110000000000111D111111D11111111111
1000001111111000110000000000100000000011111
100000000D00000000000000000000000000011111
11000001110101011111000000000011111111
1111000111101011010000000011111
11111111   1 11111111111111111